Label,Tract,County,"Full-time, year-round civilian employed population 16 years and over","Management, business, science, and arts occupations:","Management, business, and financial occupations:",Management occupations,Business and financial operations occupations,"Computer, engineering, and science occupations:",Computer and mathematical occupations,Architecture and engineering occupations,"Life, physical, and social science occupations","Education, legal, community service, arts, and media occupations:",Community and social service occupations,Legal occupations,"Educational instruction, and library occupations","Arts, design, entertainment, sports, and media occupations",Healthcare practitioners and technical occupations:,Health diagnosing and treating practitioners and other technical occupations,Health technologists and technicians,Service occupations:,Healthcare support occupations,Protective service occupations:,"Firefighting and prevention, and other protective service workers including supervisors",Law enforcement workers including supervisors,Food preparation and serving related occupations,Building and grounds cleaning and maintenance occupations,Personal care and service occupations,Sales and office occupations:,Sales and related occupations,Office and administrative support occupations,"Natural resources, construction, and maintenance occupations:","Farming, fishing, and forestry occupations",Construction and extraction occupations,"Installation, maintenance, and repair occupations","Production, transportation, and material moving occupations:",Production occupations,Transportation occupations,Material moving occupations
Estimate,9501,Adams,713,262,170,154,16,8,4,4,0,74,8,0,66,0,10,7,3,121,66,14,8,6,6,19,16,126,69,57,98,37,15,46,106,53,46,7
Estimate,9502,Adams,564,132,89,88,1,11,1,8,2,29,2,11,16,0,3,2,1,122,13,29,2,27,7,73,0,78,36,42,152,6,118,28,80,8,41,31
Estimate,9503.01,Adams,384,76,10,10,0,59,56,0,3,1,0,0,1,0,6,6,0,49,0,44,0,44,0,5,0,36,1,35,196,167,0,29,27,0,10,17
Estimate,9503.02,Adams,659,82,49,38,11,0,0,0,0,33,8,0,25,0,0,0,0,89,14,8,0,8,0,17,50,70,32,38,168,131,29,8,250,86,72,92
Estimate,9503.03,Adams,731,180,42,42,0,26,10,0,16,75,0,0,75,0,37,30,7,105,82,16,0,16,7,0,0,84,18,66,182,168,14,0,180,180,0,0
Estimate,9504,Adams,764,229,118,68,50,7,0,0,7,67,25,0,42,0,37,28,9,69,19,7,7,0,0,38,5,163,61,102,186,118,34,34,117,28,16,73
Estimate,9505,Adams,"1,713",335,195,134,61,0,0,0,0,125,0,0,125,0,15,15,0,264,90,22,0,22,0,136,16,195,95,100,440,339,53,48,479,227,92,160
Estimate,9601,Asotin,"1,273",676,259,187,72,84,0,64,20,188,23,27,92,46,145,109,36,101,34,33,21,12,14,20,0,203,64,139,179,18,76,85,114,87,9,18
Estimate,9602,Asotin,"1,847",795,311,205,106,126,104,22,0,194,25,0,169,0,164,84,80,180,45,57,19,38,0,78,0,369,77,292,247,0,168,79,256,93,47,116
Estimate,9603,Asotin,"1,120",218,86,64,22,13,13,0,0,99,46,0,53,0,20,11,9,299,113,13,6,7,92,31,50,206,144,62,219,12,143,64,178,96,15,67
Estimate,9604,Asotin,490,131,39,39,0,17,0,17,0,48,30,0,18,0,27,14,13,102,35,4,4,0,14,44,5,158,121,37,18,4,0,14,81,50,16,15
Estimate,9605,Asotin,866,268,80,50,30,55,22,19,14,53,27,0,13,13,80,80,0,113,44,0,0,0,44,25,0,170,73,97,174,0,142,32,141,106,10,25
Estimate,9606,Asotin,"1,135",355,153,130,23,39,5,10,24,72,11,0,46,15,91,48,43,124,11,0,0,0,0,15,98,304,169,135,149,0,119,30,203,113,8,82
Estimate,9400,Ferry,424,174,46,38,8,59,3,0,56,59,30,4,12,13,10,0,10,119,47,35,13,22,4,28,5,60,15,45,50,9,33,8,21,2,15,4
Estimate,9701,Ferry,641,339,109,98,11,4,4,0,0,223,33,36,133,21,3,3,0,117,27,51,4,47,0,22,17,26,0,26,23,0,23,0,136,0,0,136
Estimate,9702,Ferry,721,235,130,110,20,10,0,0,10,60,31,13,4,12,35,35,0,222,129,20,11,9,40,33,0,136,34,102,86,0,62,24,42,32,10,0
Estimate,9703,Garfield,686,261,156,134,22,67,4,17,46,20,4,0,16,0,18,18,0,132,13,28,4,24,9,74,8,121,52,69,118,64,22,32,54,19,18,17
Estimate,9601,Lincoln,515,247,115,93,22,4,0,4,0,84,22,22,40,0,44,19,25,67,31,0,0,0,0,25,11,116,21,95,41,0,22,19,44,29,11,4
Estimate,9602,Lincoln,813,358,181,162,19,65,34,1,30,79,0,29,50,0,33,21,12,136,30,66,33,33,9,23,8,126,48,78,124,5,56,63,69,14,34,21
Estimate,9603,Lincoln,786,387,196,176,20,71,33,22,16,86,8,11,49,18,34,27,7,73,17,16,10,6,0,40,0,108,42,66,146,29,55,62,72,23,35,14
Estimate,9604,Lincoln,879,420,294,255,39,19,3,11,5,85,26,18,41,0,22,12,10,133,69,22,6,16,25,16,1,132,67,65,110,48,38,24,84,34,32,18
Estimate,9701,Pend Oreille,349,181,95,81,14,45,3,37,5,41,0,5,27,9,0,0,0,25,15,0,0,0,6,4,0,37,19,18,64,4,46,14,42,28,8,6
Estimate,9702,Pend Oreille,489,146,52,28,24,18,18,0,0,35,17,0,12,6,41,41,0,75,10,1,1,0,22,22,20,85,65,20,115,27,54,34,68,30,20,18
Estimate,9703,Pend Oreille,841,236,127,67,60,24,4,12,8,79,37,0,37,5,6,0,6,196,48,15,8,7,79,12,42,126,35,91,142,89,31,22,141,13,60,68
Estimate,9704,Pend Oreille,563,181,114,74,40,24,9,8,7,8,8,0,0,0,35,35,0,61,17,25,25,0,0,5,14,93,32,61,87,0,61,26,141,141,0,0
Estimate,9705,Pend Oreille,789,377,182,78,104,76,19,51,6,83,25,0,50,8,36,36,0,61,6,13,0,13,29,13,0,227,120,107,75,0,7,68,49,23,0,26
Estimate,2.01,Spokane,892,220,107,75,32,10,10,0,0,26,26,0,0,0,77,63,14,193,49,28,28,0,47,41,28,210,122,88,113,0,35,78,156,73,30,53
Estimate,2.02,Spokane,382,86,44,34,10,0,0,0,0,10,0,0,0,10,32,32,0,120,34,46,46,0,40,0,0,76,49,27,41,0,29,12,59,49,10,0
Estimate,3.01,Spokane,848,232,49,49,0,0,0,0,0,105,22,0,64,19,78,0,78,183,98,22,22,0,0,41,22,69,21,48,83,0,83,0,281,115,24,142
Estimate,3.02,Spokane,830,194,60,11,49,17,0,17,0,82,0,0,68,14,35,24,11,238,67,0,0,0,98,11,62,173,133,40,85,0,64,21,140,99,0,41
Estimate,4,Spokane,"1,298",342,231,54,177,24,16,8,0,39,13,0,8,18,48,19,29,282,25,0,0,0,140,99,18,422,166,256,73,0,65,8,179,91,51,37
Estimate,5,Spokane,"1,343",343,172,132,40,12,7,0,5,115,43,19,38,15,44,21,23,328,55,78,49,29,78,72,45,356,184,172,121,38,63,20,195,122,34,39
Estimate,6,Spokane,"1,317",486,229,113,116,130,90,25,15,95,23,21,12,39,32,23,9,87,51,16,0,16,5,15,0,262,92,170,164,0,99,65,318,145,78,95
Estimate,7,Spokane,"1,981",689,256,214,42,161,123,20,18,144,44,20,76,4,128,128,0,362,183,71,61,10,87,0,21,444,159,285,170,0,99,71,316,10,175,131
Estimate,8,Spokane,"1,711",745,195,168,27,127,26,33,68,237,66,19,117,35,186,106,80,239,70,46,15,31,19,62,42,393,172,221,74,0,40,34,260,188,27,45
Estimate,9,Spokane,"1,854",816,250,121,129,215,99,100,16,223,33,61,66,63,128,37,91,282,16,19,19,0,65,81,101,472,237,235,201,23,159,19,83,28,33,22
Estimate,10,Spokane,"1,897",790,276,203,73,65,42,6,17,229,61,42,107,19,220,209,11,360,82,144,43,101,81,30,23,323,52,271,135,0,95,40,289,115,11,163
Estimate,11,Spokane,"1,227",613,195,102,93,160,13,133,14,171,28,0,115,28,87,19,68,44,0,14,7,7,0,30,0,391,166,225,34,0,34,0,145,63,21,61
Estimate,12,Spokane,819,328,139,58,81,57,15,32,10,111,40,5,39,27,21,10,11,183,65,11,11,0,57,30,20,95,38,57,91,0,17,74,122,31,59,32
Estimate,13,Spokane,"1,254",430,205,106,99,91,53,22,16,83,0,21,41,21,51,31,20,193,49,18,18,0,27,39,60,260,91,169,213,0,25,188,158,76,8,74
Estimate,14,Spokane,"1,863",517,228,159,69,39,39,0,0,194,133,0,61,0,56,36,20,435,128,7,7,0,158,90,52,520,180,340,251,0,102,149,140,86,46,8
Estimate,15,Spokane,"1,637",287,61,47,14,31,31,0,0,138,104,16,18,0,57,41,16,517,260,45,0,45,146,51,15,349,142,207,175,0,159,16,309,110,131,68
Estimate,16,Spokane,"1,032",210,130,98,32,56,48,8,0,17,0,0,0,17,7,0,7,176,25,0,0,0,91,42,18,163,118,45,211,0,173,38,272,86,71,115
Estimate,18,Spokane,830,246,144,135,9,33,29,0,4,69,0,56,7,6,0,0,0,192,35,24,24,0,123,10,0,244,94,150,49,0,30,19,99,51,20,28
Estimate,19,Spokane,"1,186",472,289,218,71,40,20,20,0,123,45,0,78,0,20,0,20,233,129,24,0,24,24,40,16,202,44,158,132,0,41,91,147,54,43,50
Estimate,20,Spokane,"1,132",280,60,40,20,37,25,4,8,72,9,0,57,6,111,26,85,187,62,0,0,0,29,77,19,248,79,169,115,0,62,53,302,75,110,117
Estimate,21,Spokane,"1,080",258,132,60,72,17,17,0,0,77,26,9,21,21,32,32,0,212,74,3,3,0,56,0,79,361,164,197,101,35,52,14,148,69,24,55
Estimate,23,Spokane,"1,552",533,322,137,185,0,0,0,0,130,15,14,74,27,81,73,8,386,7,0,0,0,77,253,49,378,183,195,109,0,52,57,146,75,18,53
Estimate,24,Spokane,553,252,116,104,12,35,9,0,26,95,27,36,32,0,6,6,0,65,32,0,0,0,17,16,0,68,15,53,94,0,94,0,74,44,18,12
Estimate,25,Spokane,821,227,46,32,14,85,19,52,14,35,25,0,0,10,61,12,49,217,7,0,0,0,96,48,66,184,39,145,64,0,37,27,129,120,9,0
Estimate,25.02,Spokane,771,91,29,29,0,17,0,0,17,12,12,0,0,0,33,33,0,0,0,0,0,0,0,0,0,319,149,170,153,66,73,14,208,65,24,119
Estimate,25.03,Spokane,272,119,62,62,0,18,18,0,0,39,0,0,39,0,0,0,0,85,0,0,0,0,79,0,6,20,8,12,8,0,8,0,40,0,0,40
Estimate,26,Spokane,"1,671",413,115,80,35,79,79,0,0,155,13,0,122,20,64,33,31,212,68,18,0,18,17,109,0,481,186,295,101,0,101,0,464,100,149,215
Estimate,29,Spokane,998,432,312,115,197,57,48,9,0,38,30,8,0,0,25,25,0,58,10,6,6,0,8,18,16,261,131,130,72,0,9,63,175,116,27,32
Estimate,30,Spokane,696,226,87,71,16,13,13,0,0,98,0,0,82,16,28,26,2,91,33,6,6,0,37,0,15,134,17,117,86,19,37,30,159,92,7,60
Estimate,31,Spokane,"1,878",959,391,218,173,76,76,0,0,330,259,25,46,0,162,126,36,215,144,12,0,12,27,0,32,420,103,317,104,0,91,13,180,45,79,56
Estimate,32,Spokane,"1,015",549,250,158,92,85,54,12,19,137,10,26,52,49,77,40,37,45,21,0,0,0,8,16,0,149,56,93,62,0,0,62,210,186,24,0
Estimate,35,Spokane,566,234,115,94,21,27,6,21,0,51,21,12,18,0,41,41,0,93,23,0,0,0,70,0,0,149,59,90,26,0,26,0,64,42,0,22
Estimate,36.01,Spokane,473,315,118,50,68,17,17,0,0,74,0,0,65,9,106,106,0,52,0,0,0,0,42,10,0,87,23,64,6,0,6,0,13,13,0,0
Estimate,36.02,Spokane,956,323,169,169,0,19,19,0,0,58,0,20,21,17,77,77,0,297,15,14,0,14,105,78,85,245,87,158,24,14,10,0,67,47,0,20
Estimate,38,Spokane,578,277,105,67,38,59,34,20,5,78,6,3,50,19,35,24,11,95,41,7,0,7,43,0,4,127,64,63,27,0,20,7,52,12,6,34
Estimate,39,Spokane,441,200,72,54,18,25,0,0,25,64,45,19,0,0,39,39,0,124,28,16,0,16,19,14,47,61,31,30,11,0,0,11,45,19,7,19
Estimate,40.01,Spokane,"1,043",497,260,94,166,60,17,43,0,149,15,0,106,28,28,0,28,245,110,34,0,34,0,57,44,204,34,170,26,0,0,26,71,59,12,0
Estimate,40.02,Spokane,895,535,116,102,14,10,0,0,10,372,155,19,198,0,37,37,0,87,49,0,0,0,8,30,0,204,88,116,0,0,0,0,69,48,21,0
Estimate,41,Spokane,737,490,211,96,115,35,10,7,18,179,50,5,124,0,65,55,10,66,36,0,0,0,0,20,10,138,73,65,11,0,0,11,32,8,24,0
Estimate,42,Spokane,"1,765","1,075",425,159,266,124,29,88,7,259,9,78,97,75,267,245,22,195,62,30,5,25,65,23,15,358,97,261,40,0,40,0,97,30,7,60
Estimate,43,Spokane,"1,113",600,262,167,95,103,29,34,40,160,28,40,92,0,75,75,0,132,80,0,0,0,17,27,8,265,157,108,68,0,40,28,48,0,9,39
Estimate,44,Spokane,"1,536",964,432,314,118,128,99,13,16,215,81,27,91,16,189,170,19,175,17,34,0,34,88,36,0,232,53,179,37,0,22,15,128,100,28,0
Estimate,45,Spokane,"1,033",826,382,276,106,83,39,35,9,169,44,42,41,42,192,169,23,35,24,0,0,0,11,0,0,122,74,48,14,0,7,7,36,0,21,15
Estimate,46.01,Spokane,"1,000",444,104,90,14,92,59,22,11,248,95,51,33,69,0,0,0,169,36,23,9,14,72,38,0,220,87,133,51,0,9,42,116,49,43,24
Estimate,46.02,Spokane,"1,290",812,408,141,267,154,40,69,45,154,52,12,90,0,96,69,27,130,21,38,0,38,14,51,6,149,52,97,110,0,58,52,89,72,11,6
Estimate,47.01,Spokane,990,397,181,172,9,30,0,30,0,78,42,0,20,16,108,40,68,122,28,0,0,0,48,46,0,246,138,108,53,0,25,28,172,69,20,83
Estimate,47.02,Spokane,"1,275",701,255,111,144,34,10,14,10,305,13,99,157,36,107,107,0,145,31,67,25,42,22,17,8,243,98,145,17,0,17,0,169,89,39,41
Estimate,48,Spokane,"1,257",801,354,239,115,116,53,58,5,219,83,5,63,68,112,89,23,135,28,26,15,11,71,0,10,217,135,82,64,0,16,48,40,0,40,0
Estimate,49,Spokane,"1,781","1,053",489,165,324,87,36,51,0,302,89,135,47,31,175,78,97,161,17,107,91,16,25,12,0,442,187,255,37,0,0,37,88,12,35,41
Estimate,50,Spokane,"1,398",976,405,368,37,84,84,0,0,254,0,33,214,7,233,207,26,102,11,0,0,0,64,27,0,194,77,117,47,0,31,16,79,41,25,13
Estimate,101.01,Spokane,964,472,253,217,36,95,0,27,68,54,0,0,26,28,70,70,0,101,14,14,0,14,11,0,62,165,31,134,110,0,48,62,116,0,46,70
Estimate,101.02,Spokane,"1,155",561,366,220,146,72,23,31,18,51,0,0,17,34,72,57,15,51,25,0,0,0,0,26,0,317,244,73,162,0,52,110,64,18,18,28
Estimate,102.01,Spokane,"1,771",772,379,329,50,144,53,49,42,149,28,0,91,30,100,67,33,207,73,38,20,18,45,42,9,346,53,293,284,22,186,76,162,65,77,20
Estimate,102.03,Spokane,"1,651",839,469,352,117,63,26,0,37,213,63,40,81,29,94,94,0,189,44,51,16,35,46,48,0,342,241,101,156,0,16,140,125,0,108,17
Estimate,102.04,Spokane,834,436,280,271,9,10,10,0,0,124,0,13,103,8,22,8,14,110,0,75,9,66,0,35,0,150,121,29,47,0,33,14,91,91,0,0
Estimate,103.01,Spokane,"1,258",304,120,68,52,23,0,23,0,46,0,0,46,0,115,35,80,124,12,25,15,10,23,10,54,336,111,225,282,15,176,91,212,104,66,42
Estimate,103.03,Spokane,918,373,219,172,47,22,4,18,0,59,0,11,34,14,73,25,48,122,53,7,7,0,23,30,9,192,71,121,116,0,81,35,115,16,94,5
Estimate,103.04,Spokane,"1,495",546,240,153,87,140,16,93,31,6,3,0,3,0,160,140,20,130,56,15,0,15,0,59,0,321,117,204,197,0,121,76,301,59,198,44
Estimate,103.5,Spokane,"2,311",727,339,236,103,168,66,102,0,167,18,0,128,21,53,53,0,618,444,106,17,89,35,12,21,451,242,209,243,0,147,96,272,73,135,64
Estimate,104.01,Spokane,"1,399",426,161,78,83,53,43,0,10,104,33,0,56,15,108,23,85,297,40,69,21,48,42,69,77,265,83,182,114,0,68,46,297,184,41,72
Estimate,104.03,Spokane,"1,159",364,129,45,84,43,17,21,5,51,34,0,17,0,141,103,38,310,90,65,13,52,40,38,77,215,74,141,15,0,0,15,255,55,120,80
Estimate,104.04,Spokane,915,507,232,159,73,58,58,0,0,146,47,99,0,0,71,71,0,174,0,108,21,87,0,66,0,96,46,50,68,0,27,41,70,43,27,0
Estimate,105.04,Spokane,906,418,235,188,47,19,19,0,0,153,29,10,114,0,11,11,0,146,96,28,21,7,22,0,0,239,134,105,61,0,36,25,42,0,28,14
Estimate,105.05,Spokane,"1,244",612,303,242,61,82,35,47,0,106,20,0,78,8,121,51,70,39,0,0,0,0,35,0,4,282,85,197,269,85,149,35,42,24,18,0
Estimate,105.06,Spokane,"1,326",801,396,280,116,114,103,11,0,168,0,78,90,0,123,108,15,51,0,25,15,10,26,0,0,303,99,204,65,0,33,32,106,8,70,28
Estimate,105.07,Spokane,"1,208",654,378,267,111,56,11,45,0,150,52,45,53,0,70,56,14,130,52,48,9,39,16,0,14,203,115,88,101,0,30,71,120,43,55,22
Estimate,105.08,Spokane,"1,445",853,480,295,185,96,81,15,0,138,36,33,69,0,139,119,20,102,0,70,0,70,0,18,14,346,213,133,97,0,97,0,47,0,47,0
Estimate,106.1,Spokane,"1,124",486,179,85,94,54,20,28,6,114,17,0,87,10,139,139,0,129,28,27,21,6,0,69,5,248,133,115,57,0,29,28,204,81,41,82
Estimate,106.03,Spokane,"1,203",613,286,251,35,101,14,74,13,195,41,43,111,0,31,19,12,75,31,17,13,4,0,0,27,220,147,73,207,19,92,96,88,13,75,0
Estimate,106.04,Spokane,"1,250",716,188,73,115,160,68,25,67,314,58,10,246,0,54,43,11,128,21,51,9,42,0,0,56,244,123,121,81,0,51,30,81,16,50,15
Estimate,107.01,Spokane,"1,321",705,267,204,63,75,25,40,10,202,75,20,98,9,161,149,12,134,12,0,0,0,82,16,24,237,42,195,119,0,119,0,126,78,29,19
Estimate,107.02,Spokane,"1,002",701,223,112,111,29,12,17,0,175,61,0,61,53,274,191,83,71,0,71,24,47,0,0,0,110,54,56,36,12,24,0,84,0,46,38
Estimate,108,Spokane,567,152,79,62,17,5,5,0,0,60,37,5,18,0,8,8,0,64,24,4,0,4,3,26,7,227,141,86,66,0,51,15,58,8,27,23
Estimate,109.01,Spokane,532,172,47,47,0,73,16,57,0,38,20,0,12,6,14,0,14,106,93,0,0,0,0,0,13,104,50,54,77,0,55,22,73,15,40,18
Estimate,109.02,Spokane,595,415,249,191,58,18,0,9,9,114,45,0,62,7,34,31,3,66,10,10,10,0,21,4,21,81,70,11,13,0,13,0,20,9,0,11
Estimate,110,Spokane,"1,239",439,120,51,69,73,39,20,14,126,49,26,17,34,120,47,73,169,63,31,24,7,35,21,19,332,125,207,210,44,92,74,89,46,17,26
Estimate,111.02,Spokane,"1,586",486,242,206,36,15,15,0,0,182,16,0,83,83,47,47,0,400,283,43,43,0,20,41,13,406,92,314,81,0,48,33,213,54,76,83
Estimate,111.03,Spokane,686,148,91,78,13,4,0,4,0,42,11,31,0,0,11,11,0,227,28,0,0,0,148,51,0,102,16,86,37,0,0,37,172,66,47,59
Estimate,111.04,Spokane,976,284,127,61,66,61,61,0,0,52,0,42,10,0,44,0,44,291,143,0,0,0,61,41,46,275,198,77,66,0,66,0,60,23,0,37
Estimate,112.02,Spokane,"1,217",593,231,176,55,66,29,34,3,85,21,28,36,0,211,73,138,90,21,32,19,13,25,10,2,182,106,76,118,0,64,54,234,93,68,73
Estimate,112.03,Spokane,"2,029",690,271,217,54,140,56,19,65,217,46,0,79,92,62,27,35,286,39,41,41,0,108,69,29,431,158,273,208,0,156,52,414,83,145,186
Estimate,112.04,Spokane,777,274,90,28,62,40,23,17,0,43,20,0,0,23,101,101,0,275,77,0,0,0,57,101,40,33,0,33,40,18,0,22,155,135,20,0
Estimate,113.01,Spokane,"1,131",622,295,223,72,57,57,0,0,85,49,11,25,0,185,147,38,148,15,19,19,0,0,82,32,226,95,131,106,0,39,67,29,29,0,0
Estimate,113.02,Spokane,"1,868",833,312,132,180,140,54,86,0,205,0,0,205,0,176,89,87,298,134,0,0,0,120,0,44,523,179,344,133,0,37,96,81,42,22,17
Estimate,114,Spokane,"1,588",747,184,170,14,86,42,16,28,76,30,8,19,19,401,359,42,130,17,37,23,14,11,47,18,349,105,244,184,0,115,69,178,70,58,50
Estimate,115,Spokane,713,333,73,43,30,68,31,29,8,143,83,4,41,15,49,35,14,14,14,0,0,0,0,0,0,123,37,86,146,0,93,53,97,26,65,6
Estimate,116,Spokane,644,218,98,63,35,30,11,16,3,41,9,3,29,0,49,29,20,80,12,3,3,0,11,35,19,153,79,74,136,0,82,54,57,29,13,15
Estimate,117.01,Spokane,896,255,62,19,43,94,94,0,0,64,29,0,22,13,35,29,6,118,85,11,0,11,15,0,7,220,75,145,140,0,109,31,163,121,8,34
Estimate,117.02,Spokane,"2,463",644,197,102,95,172,129,43,0,183,51,0,58,74,92,82,10,362,179,18,18,0,132,33,0,659,336,323,105,0,41,64,693,223,183,287
Estimate,118,Spokane,"1,882",756,497,441,56,0,0,0,0,152,18,14,80,40,107,36,71,290,232,0,0,0,32,0,26,425,156,269,119,16,85,18,292,196,29,67
Estimate,119,Spokane,"1,934",604,386,160,226,38,6,32,0,87,0,0,31,56,93,46,47,421,131,40,40,0,139,57,54,316,131,185,250,39,182,29,343,139,19,185
Estimate,120,Spokane,"1,248",477,248,180,68,122,59,43,20,62,19,0,20,23,45,7,38,70,5,7,0,7,12,35,11,404,180,224,84,0,67,17,213,83,108,22
Estimate,121,Spokane,770,235,85,27,58,37,27,10,0,51,11,0,40,0,62,18,44,114,0,0,0,0,44,59,11,173,50,123,117,0,104,13,131,106,16,9
Estimate,122,Spokane,840,183,84,44,40,37,17,20,0,35,17,7,5,6,27,22,5,96,46,0,0,0,35,4,11,228,67,161,188,11,141,36,145,87,27,31
Estimate,123,Spokane,"2,102",453,97,30,67,48,33,15,0,203,53,30,67,53,105,39,66,234,64,0,0,0,100,70,0,445,99,346,473,20,186,267,497,86,131,280
Estimate,124.01,Spokane,"1,554",927,522,215,307,120,82,32,6,187,13,16,124,34,98,58,40,97,8,21,12,9,0,39,29,246,130,116,158,0,92,66,126,86,40,0
Estimate,124.02,Spokane,"2,204","1,172",564,500,64,153,119,25,9,266,25,25,157,59,189,122,67,198,13,50,0,50,69,59,7,587,295,292,165,0,82,83,82,41,0,41
Estimate,125,Spokane,"1,214",384,178,140,38,30,30,0,0,169,22,13,126,8,7,7,0,219,51,63,63,0,57,7,41,284,135,149,215,0,142,73,112,15,63,34
Estimate,126,Spokane,"1,601",696,353,169,184,147,26,93,28,99,71,0,4,24,97,68,29,222,98,32,18,14,29,44,19,442,275,167,128,0,53,75,113,33,4,76
Estimate,127.01,Spokane,"1,332",461,191,93,98,117,73,35,9,70,20,0,32,18,83,48,35,211,28,24,15,9,84,34,41,182,39,143,232,0,184,48,246,117,70,59
Estimate,127.02,Spokane,819,357,204,102,102,45,45,0,0,87,7,6,48,26,21,6,15,78,12,9,9,0,24,25,8,228,108,120,72,0,52,20,84,41,15,28
Estimate,128.01,Spokane,"1,390",407,254,180,74,28,8,20,0,63,8,13,42,0,62,44,18,193,42,18,18,0,43,66,24,426,224,202,191,0,75,116,173,65,87,21
Estimate,128.02,Spokane,"1,319",508,269,206,63,51,19,32,0,86,49,0,37,0,102,49,53,180,90,12,12,0,50,0,28,326,111,215,118,0,42,76,187,46,52,89
Estimate,129.01,Spokane,846,312,181,119,62,9,9,0,0,44,27,9,8,0,78,48,30,103,32,0,0,0,39,26,6,277,119,158,61,0,34,27,93,30,18,45
Estimate,129.02,Spokane,"2,591",769,291,178,113,125,15,54,56,165,10,34,121,0,188,147,41,268,173,38,28,10,45,0,12,792,441,351,169,0,122,47,593,300,149,144
Estimate,130.01,Spokane,517,256,70,46,24,116,116,0,0,53,11,18,0,24,17,17,0,0,0,0,0,0,0,0,0,99,48,51,76,23,18,35,86,40,22,24
Estimate,130.02,Spokane,"1,047",121,68,41,27,21,21,0,0,32,0,0,32,0,0,0,0,355,24,13,13,0,286,32,0,290,184,106,163,0,106,57,118,61,57,0
Estimate,130.03,Spokane,"1,810",869,356,223,133,96,46,50,0,336,112,53,146,25,81,65,16,93,13,34,0,34,32,0,14,336,223,113,88,0,8,80,424,53,323,48
Estimate,131.01,Spokane,"2,429","1,510",425,261,164,350,144,184,22,404,90,77,237,0,331,156,175,233,0,24,24,0,122,22,65,384,102,282,111,0,65,46,191,34,157,0
Estimate,131.02,Spokane,"1,738",821,381,182,199,122,39,64,19,176,41,31,104,0,142,69,73,18,18,0,0,0,0,0,0,446,154,292,187,0,118,69,266,152,56,58
Estimate,132.01,Spokane,"2,198",727,240,227,13,145,95,30,20,171,123,0,48,0,171,106,65,316,46,64,13,51,15,138,53,563,249,314,272,0,177,95,320,153,104,63
Estimate,132.03,Spokane,"1,006",578,332,229,103,125,31,81,13,58,0,0,23,35,63,63,0,63,10,43,26,17,10,0,0,187,120,67,86,0,86,0,92,0,92,0
Estimate,132.04,Spokane,"1,691",914,299,234,65,75,22,53,0,238,0,0,238,0,302,129,173,97,0,51,14,37,13,0,33,518,383,135,32,0,32,0,130,14,107,9
Estimate,132.05,Spokane,"1,118",462,203,84,119,58,0,44,14,92,26,0,43,23,109,79,30,180,141,13,13,0,13,13,0,327,168,159,78,50,0,28,71,12,0,59
Estimate,133,Spokane,"1,243",547,385,331,54,28,0,14,14,31,0,16,15,0,103,72,31,147,8,7,7,0,0,113,19,249,149,100,112,1,85,26,188,132,25,31
Estimate,134.01,Spokane,"1,922","1,309",592,403,189,148,91,30,27,247,57,33,149,8,322,305,17,101,21,55,44,11,11,8,6,322,209,113,127,0,81,46,63,39,13,11
Estimate,135.01,Spokane,514,246,149,80,69,43,0,0,43,33,16,0,17,0,21,0,21,38,38,0,0,0,0,0,0,106,106,0,59,0,0,59,65,0,44,21
Estimate,135.02,Spokane,761,477,336,261,75,0,0,0,0,80,14,0,66,0,61,61,0,72,45,27,20,7,0,0,0,91,40,51,60,0,44,16,61,20,0,41
Estimate,135.03,Spokane,"2,318","1,401",796,517,279,119,23,33,63,214,106,0,108,0,272,214,58,221,21,65,25,40,74,61,0,407,262,145,157,0,157,0,132,20,67,45
Estimate,136,Spokane,"1,712",660,228,142,86,162,46,39,77,241,81,11,146,3,29,14,15,226,53,47,12,35,44,39,43,497,212,285,126,0,82,44,203,72,79,52
Estimate,137,Spokane,"1,248",575,196,107,89,127,68,36,23,159,47,12,87,13,93,60,33,240,48,30,22,8,82,57,23,188,96,92,144,52,60,32,101,46,22,33
Estimate,138,Spokane,250,84,46,46,0,0,0,0,0,27,6,15,6,0,11,5,6,32,15,0,0,0,0,0,17,44,6,38,25,0,11,14,65,0,45,20
Estimate,139,Spokane,"1,727",622,401,374,27,0,0,0,0,138,65,32,41,0,83,83,0,232,120,42,29,13,12,46,12,301,105,196,173,0,0,173,399,259,104,36
Estimate,140.01,Spokane,907,251,118,36,82,63,13,24,26,70,35,0,26,9,0,0,0,176,103,0,0,0,26,40,7,258,101,157,49,36,13,0,173,103,63,7
Estimate,140.02,Spokane,"1,595",673,116,74,42,26,26,0,0,453,70,26,305,52,78,63,15,247,85,55,24,31,35,18,54,474,213,261,97,36,11,50,104,64,40,0
Estimate,141,Spokane,"1,824",917,469,359,110,87,39,48,0,200,1,11,146,42,161,161,0,326,149,95,0,95,14,24,44,228,104,124,221,29,67,125,132,92,13,27
Estimate,142,Spokane,"1,120",540,324,234,90,50,16,34,0,90,52,0,25,13,76,24,52,122,2,56,26,30,49,0,15,199,88,111,211,0,194,17,48,17,10,21
Estimate,143,Spokane,942,355,158,139,19,56,4,8,44,86,22,1,63,0,55,38,17,87,31,16,6,10,13,19,8,214,59,155,186,44,98,44,100,60,29,11
Estimate,144,Spokane,"1,427",527,240,139,101,112,22,10,80,66,19,0,47,0,109,64,45,122,88,8,8,0,6,8,12,258,120,138,348,0,187,161,172,92,21,59
Estimate,145,Spokane,472,135,91,66,25,22,22,0,0,14,0,0,6,8,8,8,0,67,50,0,0,0,13,4,0,175,95,80,50,0,37,13,45,23,11,11
Estimate,9410,Stevens,532,170,86,62,24,13,0,2,11,65,17,0,48,0,6,5,1,96,14,23,20,3,24,17,18,125,41,84,74,29,30,15,67,39,24,4
Estimate,9501.01,Stevens,973,214,108,77,31,11,5,2,4,42,7,0,35,0,53,27,26,235,88,19,13,6,26,73,29,186,73,113,142,22,45,75,196,148,19,29
Estimate,9501.02,Stevens,868,202,48,24,24,0,0,0,0,38,26,3,9,0,116,63,53,110,31,27,22,5,25,13,14,356,222,134,92,14,40,38,108,32,29,47
Estimate,9502,Stevens,"1,144",462,254,167,87,20,12,0,8,136,0,0,127,9,52,27,25,81,39,13,13,0,0,16,13,164,27,137,218,0,74,144,219,181,38,0
Estimate,9503,Stevens,559,213,48,37,11,16,1,8,7,110,26,52,32,0,39,29,10,117,25,0,0,0,27,7,58,109,57,52,63,16,7,40,57,30,27,0
Estimate,9505,Stevens,550,241,69,49,20,69,41,23,5,47,6,0,20,21,56,37,19,39,38,0,0,0,0,1,0,98,53,45,38,0,15,23,134,55,40,39
Estimate,9506,Stevens,508,199,107,61,46,50,15,26,9,42,4,28,10,0,0,0,0,85,37,27,23,4,5,6,10,72,17,55,61,4,9,48,91,27,33,31
Estimate,9507,Stevens,616,196,120,98,22,14,14,0,0,43,9,0,34,0,19,4,15,100,26,8,0,8,10,56,0,140,122,18,54,0,32,22,126,24,55,47
Estimate,9508,Stevens,651,269,125,70,55,55,2,53,0,63,15,0,46,2,26,26,0,94,30,46,0,46,0,0,18,73,42,31,116,12,35,69,99,56,28,15
Estimate,9509,Stevens,312,111,42,22,20,22,3,7,12,33,13,0,16,4,14,14,0,34,8,19,12,7,0,2,5,56,16,40,55,16,21,18,56,24,26,6
Estimate,9511,Stevens,670,160,78,50,28,2,2,0,0,60,0,15,41,4,20,17,3,84,50,0,0,0,12,22,0,110,43,67,201,18,94,89,115,52,43,20
Estimate,9513.01,Stevens,803,180,74,39,35,43,37,6,0,4,0,0,4,0,59,59,0,153,35,35,25,10,8,60,15,154,56,98,165,0,65,100,151,20,41,90
Estimate,9513.02,Stevens,368,119,35,20,15,39,21,18,0,45,0,0,45,0,0,0,0,68,0,22,7,15,16,14,16,61,22,39,85,0,38,47,35,15,11,9
Estimate,9514.01,Stevens,829,236,142,68,74,36,0,36,0,58,21,0,37,0,0,0,0,126,0,8,0,8,90,0,28,98,43,55,199,12,161,26,170,93,54,23
Estimate,9514.02,Stevens,"1,467",639,354,296,58,74,38,19,17,115,17,0,98,0,96,32,64,245,60,118,52,66,15,37,15,189,103,86,97,0,41,56,297,125,122,50
Estimate,1,Whitman,220,94,50,39,11,8,0,0,8,34,0,0,34,0,2,0,2,17,12,0,0,0,3,2,0,30,19,11,52,9,16,27,27,21,0,6
Estimate,2.01,Whitman,"1,645",874,386,305,81,315,67,106,142,112,17,3,92,0,61,42,19,210,0,104,28,76,0,78,28,254,164,90,80,10,42,28,227,105,122,0
Estimate,2.02,Whitman,"1,162",720,296,201,95,80,59,17,4,269,38,0,231,0,75,66,9,48,6,0,0,0,23,19,0,95,40,55,30,30,0,0,269,184,70,15
Estimate,3,Whitman,"2,240","1,694",477,348,129,282,139,41,102,809,29,0,654,126,126,126,0,155,73,23,23,0,0,30,29,55,15,40,180,0,14,166,156,156,0,0
Estimate,4,Whitman,"1,358",777,266,180,86,135,3,52,80,340,17,0,261,62,36,36,0,279,32,29,15,14,31,139,48,209,122,87,65,11,28,26,28,15,3,10
Estimate,5,Whitman,170,76,0,0,0,3,0,0,3,62,0,0,62,0,11,11,0,13,0,0,0,0,0,0,13,67,67,0,0,0,0,0,14,2,0,12
Estimate,6.01,Whitman,503,315,5,5,0,98,44,0,54,212,14,0,190,8,0,0,0,24,0,0,0,0,0,24,0,77,17,60,60,0,0,60,27,17,0,10
Estimate,6.02,Whitman,734,444,38,38,0,206,0,181,25,168,0,0,94,74,32,32,0,152,66,0,0,0,59,27,0,133,133,0,5,5,0,0,0,0,0,0
Estimate,7,Whitman,"1,215",563,304,266,38,54,16,24,14,89,13,7,65,4,116,100,16,121,17,18,11,7,25,61,0,221,85,136,169,55,81,33,141,64,43,34
Estimate,8,Whitman,"1,032",430,223,162,61,109,40,50,19,77,17,8,34,18,21,10,11,157,53,51,22,29,30,9,14,139,25,114,222,12,166,44,84,44,10,30
Estimate,9,Whitman,"1,048",466,299,250,49,41,32,4,5,65,17,3,41,4,61,39,22,85,22,30,15,15,11,18,4,220,93,127,162,40,55,67,115,34,46,35
Estimate,10,Whitman,850,477,276,253,23,78,22,26,30,48,5,3,34,6,75,45,30,81,11,8,0,8,14,9,39,126,51,75,113,37,48,28,53,21,20,12
Estimate,,Adams,"5,528","1,296",673,534,139,111,71,12,28,404,43,11,350,0,108,88,20,819,284,140,17,123,20,288,87,752,312,440,"1,422",966,263,193,"1,239",582,277,380
Estimate,,Asotin,"6,731","2,443",928,675,253,334,144,132,58,654,162,27,391,74,527,346,181,919,282,107,50,57,164,213,153,"1,410",648,762,986,34,648,304,973,545,105,323
Estimate,,Ferry County,"1,786",748,285,246,39,73,7,0,66,342,94,53,149,46,48,38,10,458,203,106,28,78,44,83,22,222,49,173,159,9,118,32,199,34,25,140
Estimate,,Garfield,686,261,156,134,22,67,4,17,46,20,4,0,16,0,18,18,0,132,13,28,4,24,9,74,8,121,52,69,118,64,22,32,54,19,18,17
Estimate,,Lincoln,"2,993","1,412",786,686,100,159,70,38,51,334,56,80,180,18,133,79,54,409,147,104,49,55,34,104,20,482,178,304,421,82,171,168,269,100,112,57
Estimate,,Pend Oreille,"3,031","1,121",570,328,242,187,53,108,26,246,87,5,126,28,118,112,6,418,96,54,34,20,136,56,76,568,271,297,483,120,199,164,441,235,88,118
Estimate,,Spokane County,"161,315","68,374","30,358","19,916","10,442","9,151","4,418","3,215","1,518","16,993","4,430","2,061","8,358","2,144","11,872","8,227","3,645","22,347","7,018","3,272","1,502","1,770","5,406","4,073","2,578","35,346","15,601","19,745","14,885",767,"8,411","5,707","20,363","8,361","6,219","5,783"
Estimate,,Stevens County,"10,850","3,611","1,690","1,140",550,464,191,200,73,901,161,98,602,40,556,340,216,"1,667",481,365,187,178,258,324,239,"1,991",937,"1,054","1,660",143,707,810,"1,921",921,590,410
Estimate,,Whitman County,"12,177","6,930","2,620","2,047",573,"1,409",422,501,486,"2,285",167,24,"1,792",302,616,507,109,"1,342",292,263,114,149,196,416,175,"1,626",831,795,"1,138",209,450,479,"1,141",663,314,164
Estimate,,Spokane City,"70,033","29,212","12,148","7,461","4,687","3,904","1,870","1,178",856,"8,409","2,252","1,079","3,967","1,111","4,751","3,387","1,364","11,280","3,345","1,306",644,662,"3,091","2,234","1,304","14,932","6,124","8,808","5,519",244,"3,207","2,068","9,090","3,975","2,233","2,882"
Estimate,,Spokane - Spokane Valley,"172,165","71,985","32,048","21,056","10,992","9,615","4,609","3,415","1,591","17,894","4,591","2,159","8,960","2,184","12,428","8,567","3,861","24,014","7,499","3,637","1,689","1,948","5,664","4,397","2,817","37,337","16,538","20,799","16,545",910,"9,118","6,517","22,284","9,282","6,809","6,193"
,,,,,,,,,,,,,,,,,,,,,,,,,,,,,,,,,,,,,,
Mean,,,"3,363","1,410",620,412,208,193,89,67,37,364,89,41,190,44,233,162,71,476,147,71,32,39,110,92,56,708,311,396,333,31,177,126,436,186,126,123
Std,,," 17,487 "," 7,359 "," 3,255 "," 2,129 "," 1,128 ", 987 , 474 , 346 , 171 ," 1,857 ", 481 , 226 , 923 , 233 ," 1,268 ", 879 , 391 ," 2,465 ", 769 , 361 , 168 , 194 , 599 , 456 , 287 ," 3,804 "," 1,674 "," 2,131 "," 1,634 ", 116 , 912 , 636 ," 2,243 ", 934 , 676 , 637 
